111111111111111111
10P000000000000C01
10000C000001E00001
100C00000000000001
111111111111111111