111111111
100000001
10P000001
100000E00
111111111
