111111111
1000000C1
10P000001
100000001
111111111
