1111111
1000000C1
100000001
100000E01
111111111