1111111111111111
1P00001000000C01
1000001000001111
10000000C00110E1
1000C10000011111
100001000000C001
1000000C00000001
1111111111111111