1111111111111111
1P00001000000C01
1000001000001011
10000000C00110E1
1000C10000011111
100001001000C001
1000010C10000001
1111111111111111