11111111111
1000000C001
100000P1001
10C0000E001
11111111111