1111111111111111
1P00001000000C01
1000001000000001
10000000C00100E1
1000C10000010001
100001000000C001
1000000C00000001
1111111111111111