1111111111111111
1P00001000000C01
1000001000000001
10000000C00000E1
1000C10000000001
10000100000C0001
1000000C00000001
1111111111111111