111111111
1000000C1
10P000011
10C0000E1
111111111