11111111111111111111111111111111111111111111111111
10000000000000000000000000000000000000000000000001
10000000C0010000000000000P000000000000000000000001
100000000001111000000C0000000000000000000000000001
1000000000010000000000000C000000000000000000000001
10000000000100000000000000000000000000000000000001
1000000000000000000000C000000000000000000000000001
1000C00011111110000000000C000000000000111111111001
10000000000100000000000000000000000000000010000001
100000000001000000000000000000000000000000100E0001
1000000000010000000000000C000000000000000010000001
10000000000000000000000000000000000000111110000001
100C0000000000000000000000000000000000000010000001
10000000000000000000000000000000000000000010000001
11111111111111111111111111111111111111111111111111