1111111111111111
1P00001000000C01
1111000000000111
10000000C0010001
1000C10000011111
100001001000C001
1000010C100000E1
1111111111111111