111111111
1000000C1
10P000001
100000E01
111111111