11111111111
1C0000C0001
10P00001111
1C0000000E1
11111111111