11111111111111111111111111111111111
10C0000000000001000C000000000000C01
10000000000C00010000000000000000001
10000000000000000000000000000000001
10000001000000000000000111110000001
10C000010000000P000000C1E0000000001
11111111111111111111111111111111111