111111111111
1P00000000C1
100C00000001
100000000E01
111111111111